Date,NR,WR,SR,ER,NER,TOTAL
1-Jan-15,835774,843214,708449,242186,34029,2663652
2-Jan-15,772043,872452,709401,250680,35225,2639801
3-Jan-15,853387,898691,718161,243188,34170,2747597
4-Jan-15,773651,842609,711702,214599,30153,2572714
5-Jan-15,798833,785888,716753,225151,31636,2558261
6-Jan-15,801387,785888,744784,225317,31659,2589035
7-Jan-15,862622,814793,762598,240244,33754,2714011
8-Jan-15,865863,813053,778741,240282,33762,2731701
9-Jan-15,883740,821516,789797,256938,36103,2788094
10-Jan-15,866170,836555,787008,260338,36580,2786651
11-Jan-15,848561,850697,776304,258233,36285,2770080
12-Jan-15,819183,854678,762527,250807,35241,2722436
13-Jan-15,878684,859029,778946,262746,36917,2816322
14-Jan-15,897203,870128,780801,261930,36804,2846866
15-Jan-15,858915,862978,772668,260610,36618,2791789
16-Jan-15,860082,854685,742283,262211,36843,2756104
17-Jan-15,843868,868356,730844,256153,35992,2735213
18-Jan-15,810308,886573,724863,253128,35562,2710434
19-Jan-15,857892,873924,736254,262967,36950,2767987
20-Jan-15,790772,874985,756221,251293,35310,2708581
21-Jan-15,859060,885295,764771,257554,36187,2802867
22-Jan-15,817006,874660,759949,254676,35787,2742078
23-Jan-15,825691,840696,748115,255308,35874,2705684
24-Jan-15,773876,862996,753266,253536,35621,2679295
25-Jan-15,797137,864816,745914,253998,35690,2697555
26-Jan-15,755312,810869,729415,238510,33513,2567619
27-Jan-15,824669,810869,713269,256164,35994,2640965
28-Jan-15,832767,842426,747767,237675,33393,2694028
29-Jan-15,783238,842426,766556,230541,32392,2655153
30-Jan-15,823387,818714,760225,248955,34980,2686261
31-Jan-15,838176,844870,748298,258045,36257,2725646
1-Feb-15,712616,841797,755284,244876,34407,2588980
2-Feb-15,809128,839063,751669,253673,35643,2689176
3-Feb-15,809854,914063,768703,270906,38066,2801592
4-Feb-15,805243,919703,779072,254244,35724,2793986
5-Feb-15,836625,919703,790428,245104,34439,2826299
6-Feb-15,804526,898612,800310,251239,35302,2789989
7-Feb-15,809718,898612,810601,253547,35624,2808102
8-Feb-15,762927,916200,786589,275872,38762,2780350
9-Feb-15,810251,877324,790378,273914,38485,2790352
10-Feb-15,737356,898286,800224,273507,38429,2747802
11-Feb-15,742222,861351,805401,268268,37692,2714934
12-Feb-15,812752,842891,811688,271097,38092,2776520
13-Feb-15,747303,863428,827180,255271,35868,2729050
14-Feb-15,817126,882953,822104,265882,37359,2825424
15-Feb-15,780397,903519,807698,244329,34328,2770271
16-Feb-15,798171,891208,794130,267038,37522,2788069
17-Feb-15,728306,921696,807727,266226,37407,2761362
18-Feb-15,722453,898523,810301,269533,37871,2738681
19-Feb-15,791482,938274,802301,268856,37777,2838690
20-Feb-15,773831,954913,801030,265656,37327,2832757
21-Feb-15,715260,931717,785450,261928,36803,2731158
22-Feb-15,679161,919336,784094,234596,32963,2650150
23-Feb-15,802128,897691,775819,264018,37097,2776753
24-Feb-15,814241,935741,780703,279031,39207,2848923
25-Feb-15,763640,950138,795938,271864,38199,2819779
26-Feb-15,764076,930370,807003,261096,36686,2799231
27-Feb-15,794010,935986,810375,260930,36664,2837965
28-Feb-15,781351,920819,793624,261724,36776,2794294
1-Mar-15,599240,793168,773690,269020,37800,2472918
2-Mar-15,663605,669323,780031,243880,34269,2391108
3-Mar-15,693058,705927,793193,241479,33930,2467587
4-Mar-15,705495,735289,804625,235194,33046,2513649
5-Mar-15,720138,778948,804575,264286,37136,2605083
6-Mar-15,585458,811607,802681,256172,35993,2491911
7-Mar-15,584941,811607,800734,268050,37665,2502997
8-Mar-15,658210,780068,783875,275919,38767,2536839
9-Mar-15,696337,780068,779754,296184,41618,2593961
10-Mar-15,709767,818879,799039,295665,41543,2664893
11-Mar-15,726309,871312,811788,295738,41556,2746703
12-Mar-15,734969,876853,816980,308500,43345,2780647
13-Mar-15,735489,851454,835257,292170,41053,2755423
14-Mar-15,684912,864653,843067,296204,41620,2730456
15-Mar-15,617049,869619,823158,269907,37924,2617657
16-Mar-15,669667,857917,820295,288327,40511,2676717
17-Mar-15,683354,857917,835616,301771,42400,2721058
18-Mar-15,697977,854016,832626,295206,41479,2721304
19-Mar-15,728045,854016,839013,301711,42395,2765180
20-Mar-15,716427,886051,842957,306706,43096,2795237
21-Mar-15,734331,892146,832092,292822,41145,2792536
22-Mar-15,655452,902478,814276,283030,39770,2695006
23-Mar-15,696292,896937,792030,295841,41569,2722669
24-Mar-15,770101,938497,825842,306612,43080,2884132
25-Mar-15,801161,938497,847887,315447,44321,2947313
26-Mar-15,774190,969624,855675,306802,43108,2949399
27-Mar-15,723115,969624,849112,310230,43591,2895672
28-Mar-15,697618,941517,853139,304085,42727,2839086
29-Mar-15,603210,936419,845511,281702,39582,2706424
30-Mar-15,643539,869290,832030,222535,31265,2598659
31-Mar-15,674575,890249,839210,259317,36439,2699790
1-Apr-15,729037,939253,819137,286597,40268,2814292
2-Apr-15,764104,939253,814261,280995,39482,2838095
3-Apr-15,785848,918207,813653,288827,40583,2847118
4-Apr-15,774377,918207,816399,268327,37702,2815012
5-Apr-15,745394,918806,810737,244573,34365,2753875
6-Apr-15,783827,857054,832380,258692,36347,2768300
7-Apr-15,780122,970066,819359,233057,32747,2835351
8-Apr-15,797122,949031,808821,247177,34732,2836883
9-Apr-15,802972,946500,806646,271547,38155,2865820
10-Apr-15,833786,970962,812341,295443,41511,2954043
11-Apr-15,767348,953985,792638,262200,36841,2813012
12-Apr-15,736279,925390,767833,236080,33173,2698755
13-Apr-15,795353,806103,746425,271853,38198,2657932
14-Apr-15,802768,843464,745401,279016,39200,2709849
15-Apr-15,769396,836049,735754,273833,38476,2653508
16-Apr-15,816500,876496,733265,296520,41664,2764445
17-Apr-15,830216,898693,728559,275402,38698,2771568
18-Apr-15,809000,944050,730440,277498,38991,2799979
19-Apr-15,749909,944050,724098,275904,38768,2732729
20-Apr-15,867450,964113,739746,293625,41256,2906190
21-Apr-15,896197,985957,746089,250217,35160,2913620
22-Apr-15,871662,985957,751352,256199,35998,2901168
23-Apr-15,876792,978950,754465,197385,27736,2835328
24-Apr-15,813701,978735,771371,255500,35900,2855207
25-Apr-15,839197,963645,773524,237198,33329,2846893
26-Apr-15,768960,959239,719870,216697,30450,2695216
27-Apr-15,824754,895106,731175,250182,35151,2736368
28-Apr-15,805489,960625,748516,155044,21784,2691458
29-Apr-15,828102,968376,776355,272517,38290,2883640
30-Apr-15,807833,976273,762638,265807,37351,2849902
1-May-15,862368,943718,752725,274902,38628,2872341
2-May-15,900561,918833,745767,265474,37299,2867934
3-May-15,839253,946430,747862,255367,35883,2824795
4-May-15,926837,951605,744161,286602,40272,2949477
5-May-15,885528,954753,772909,298602,41956,2953748
6-May-15,956940,944979,779739,304597,42799,3029054
7-May-15,964432,944979,776385,307244,43170,3036210
8-May-15,988148,941536,785973,306486,43066,3065209
9-May-15,1000684,941536,761826,300925,42284,3047255
10-May-15,935885,939663,745214,293410,41226,2955398
11-May-15,934194,893821,743110,285300,40088,2896513
12-May-15,887954,960757,750490,284179,39931,2923311
13-May-15,891390,969565,739306,291838,41005,2933104
14-May-15,900108,925406,730061,303534,42650,2901759
15-May-15,915911,921249,727945,277620,39009,2881734
16-May-15,909764,925297,713060,277620,39009,2864750
17-May-15,853382,917568,683781,292895,41155,2788781
18-May-15,907777,911633,676485,305474,42922,2844291
19-May-15,717796,960652,677080,311001,43698,2710227
20-May-15,905650,936585,705208,309442,43476,2900361
21-May-15,927491,956441,730695,296970,41730,2953327
22-May-15,936332,956441,751770,304819,42829,2992191
23-May-15,912155,944653,758808,282793,39736,2938145
24-May-15,931895,940981,749284,257188,36137,2915485
25-May-15,951885,908383,782516,259902,36518,2939204
26-May-15,955471,960980,817515,272046,38224,3044236
27-May-15,901589,967072,820209,294272,41347,3024489
28-May-15,989261,970675,767536,299389,42068,3068929
29-May-15,923378,976841,748032,292666,41124,2982041
30-May-15,976442,966130,733105,278616,39149,2993442
31-May-15,882527,962897,711260,280413,39401,2876498
1-Jun-15,890574,964183,700360,278799,39176,2873092
2-Jun-15,863542,956496,716064,301004,42291,2879397
3-Jun-15,851992,956496,733172,292888,41155,2875703
4-Jun-15,914140,949598,719704,306606,43081,2933129
5-Jun-15,889002,949598,733399,289045,40612,2901656
6-Jun-15,914350,940810,746117,290357,40798,2932432
7-Jun-15,919599,937973,711889,288465,40531,2898457
8-Jun-15,1012486,942343,723245,288329,40513,3006916
9-Jun-15,981776,914435,738129,288329,40513,2963182
10-Jun-15,962685,933235,752286,242154,34024,2924384
11-Jun-15,983795,919508,747814,242154,34024,2927295
12-Jun-15,928424,919508,750578,225813,31730,2856053
13-Jun-15,812336,879880,725290,268103,37672,2723281
14-Jun-15,839182,822784,735304,264157,37117,2698544
15-Jun-15,975130,784881,730510,289480,40675,2820676
16-Jun-15,1013952,843868,739686,296677,41685,2935868
17-Jun-15,1084702,844851,731856,297898,41857,3001164
18-Jun-15,1091040,842446,726088,288529,40542,2988645
19-Jun-15,1047027,835490,722383,273397,38415,2916712
20-Jun-15,1007557,828856,702432,266962,37510,2843317
21-Jun-15,927445,825659,658348,252927,35538,2699917
22-Jun-15,997289,755318,651459,273857,38478,2716401
23-Jun-15,965195,775007,698945,273022,38361,2750530
24-Jun-15,959347,767268,733189,265024,37240,2762068
25-Jun-15,954046,690506,759841,263303,36999,2704695
26-Jun-15,989813,733884,763729,263718,37055,2788199
27-Jun-15,1020557,758046,747212,270059,37947,2833821
28-Jun-15,1014037,804717,744355,266113,37392,2866614
29-Jun-15,901972,772961,747174,291122,40904,2754133
30-Jun-15,912144,878540,760216,290562,40825,2882287
1-Jul-15,965869,898621,768862,276491,38847,2948690
2-Jul-15,1063613,871334,771584,266123,37392,3010046
3-Jul-15,1019670,898419,784624,282759,39731,3025203
4-Jul-15,1081293,906898,774831,282575,39706,3085303
5-Jul-15,1051775,909178,764674,281588,39562,3046777
6-Jul-15,1012772,911180,770455,272360,38268,3005035
7-Jul-15,975992,926169,787381,273213,38390,3001145
8-Jul-15,1027317,941156,799101,275003,38642,3081219
9-Jul-15,994562,937679,795402,282713,39723,3050079
10-Jul-15,928138,917571,779280,260166,36557,2921712
11-Jul-15,806385,916132,778305,260166,36557,2797545
12-Jul-15,778439,924301,781876,279057,39211,2802884
13-Jul-15,888977,924301,780746,283331,39809,2917164
14-Jul-15,985256,983088,790704,282402,39680,3081130
15-Jul-15,1058483,983088,793097,233072,32748,3100488
16-Jul-15,1007445,1002007,794809,278561,39140,3121962
17-Jul-15,1058871,1008195,792795,276421,38839,3175121
18-Jul-15,943540,980098,772432,270947,38071,3005088
19-Jul-15,936621,935837,729318,269833,37915,2909524
20-Jul-15,977283,862903,722270,284648,39995,2887099
21-Jul-15,1004151,862903,743271,265944,37367,2913636
22-Jul-15,1045418,851989,748551,265263,37270,2948491
23-Jul-15,1043857,851989,728674,259141,36413,2920074
24-Jul-15,1032373,858164,744824,259754,36496,2931611
25-Jul-15,1026824,840884,762972,257894,36236,2924810
26-Jul-15,938988,780369,758700,238924,33570,2750551
27-Jul-15,981866,755209,746761,237997,33440,2755273
28-Jul-15,965631,768272,754183,271264,38115,2797465
29-Jul-15,1027826,768272,765100,287164,40348,2888710
30-Jul-15,1034400,807802,770269,275809,38754,2927034
31-Jul-15,1005767,807802,746274,252012,35409,2847264
1-Aug-15,909679,799978,781320,230272,32356,2753605
2-Aug-15,870112,814999,741037,246033,34570,2706751
3-Aug-15,968253,797428,743270,275150,38661,2822762
4-Aug-15,993972,831317,744958,275150,38661,2884058
5-Aug-15,1056126,808392,766583,283991,39901,2954993
6-Aug-15,1068677,808392,766743,283991,39901,2967704
7-Aug-15,1065661,846529,778331,293572,41250,3025343
8-Aug-15,977440,846529,783112,292205,41056,2940342
9-Aug-15,929599,852279,776340,274998,38642,2871858
10-Aug-15,1042804,843167,766536,302557,42513,2997577
11-Aug-15,1010889,887576,775752,310497,43628,3028342
12-Aug-15,1040697,878032,770372,308742,43381,3041224
13-Aug-15,997758,868481,782818,296924,41721,2987702
14-Aug-15,1005064,868481,791881,262439,36874,2964739
15-Aug-15,906090,761926,786782,269187,37826,2761811
16-Aug-15,903162,761926,755765,268610,37743,2727206
17-Aug-15,1007041,790195,748329,287101,40342,2873008
18-Aug-15,987890,853187,746060,305202,42885,2935224
19-Aug-15,1025089,882228,745923,308649,43369,3005258
20-Aug-15,1041080,882228,752868,306166,43019,3025361
21-Aug-15,1026024,903846,753807,297182,41756,3022615
22-Aug-15,1011319,915675,728048,297182,41756,2993980
23-Aug-15,971217,915675,713290,294695,41409,2936286
24-Aug-15,1047212,898668,707694,289328,40653,2983555
25-Aug-15,1099728,954051,749731,300269,42190,3145969
26-Aug-15,1119668,951356,747576,296255,41626,3156481
27-Aug-15,1129443,936311,746707,287530,40401,3140392
28-Aug-15,1127453,965257,752493,302928,42565,3190696
29-Aug-15,1085027,952866,761413,279652,39293,3118251
30-Aug-15,1083129,878930,748848,278431,39123,3028461
31-Aug-15,1124727,906764,761053,301121,42312,3135977
1-Sep-15,1101203,942175,762631,299150,42034,3147193
2-Sep-15,1114646,954933,765003,287085,40340,3162007
3-Sep-15,1115062,972247,760364,311544,43775,3202992
4-Sep-15,1133587,972247,740176,301702,42393,3190105
5-Sep-15,1083245,980281,740706,301702,42393,3148327
6-Sep-15,1067479,980281,726102,303016,42576,3119454
7-Sep-15,1135130,946952,722557,303016,42576,3150231
8-Sep-15,1148754,977391,721329,301878,42417,3191769
9-Sep-15,1146258,1008745,724433,308308,43320,3231064
10-Sep-15,1120583,1004802,736392,309463,43484,3214724
11-Sep-15,1141205,984231,734082,304745,42822,3207085
12-Sep-15,1128412,980168,756545,292994,41169,3199288
13-Sep-15,1099482,974568,760954,291898,41012,3167914
14-Sep-15,1062521,905635,747029,270612,38022,3023819
15-Sep-15,1055124,937379,766263,273065,38369,3070200
16-Sep-15,1069224,929446,780346,293526,41242,3113784
17-Sep-15,1020330,916752,767891,280735,39446,3025154
18-Sep-15,1040450,854476,761391,282256,39658,2978231
19-Sep-15,1035230,854476,763610,289364,40656,2983336
20-Sep-15,905409,829147,748771,272404,38277,2794008
21-Sep-15,916269,804666,727817,272542,38296,2759590
22-Sep-15,848922,804666,735860,272932,38351,2700731
23-Sep-15,861324,856011,763068,276616,38869,2795888
24-Sep-15,943093,882518,754317,283110,39777,2902815
25-Sep-15,937740,907585,744660,282070,39633,2911688
26-Sep-15,897767,906801,732431,283440,39827,2860266
27-Sep-15,847759,924172,722458,296172,41616,2832177
28-Sep-15,993498,881808,714884,307440,43198,2940828
29-Sep-15,1010721,978237,722496,307440,43198,3062092
30-Sep-15,1019340,996234,721286,305826,42971,3085657
1-Oct-15,988597,987355,723193,283096,39779,3022020
2-Oct-15,951751,977743,694181,282733,39726,2946134
3-Oct-15,999217,970915,675663,275963,38778,2960536
4-Oct-15,968425,964805,652757,279862,39321,2905170
5-Oct-15,1014747,939037,667070,278438,39125,2938417
6-Oct-15,1003016,972915,696550,278438,39125,2990044
7-Oct-15,1016082,1000855,700789,278438,39125,3035289
8-Oct-15,1038075,1016698,709720,292113,41046,3097652
9-Oct-15,1013610,1035642,705512,292113,41046,3087923
10-Oct-15,982596,1042072,724930,291218,40919,3081735
11-Oct-15,893619,1047230,722830,288705,40566,2992950
12-Oct-15,986113,1014190,715669,283013,39763,3038748
13-Oct-15,947438,1036124,703408,286667,40280,3013917
14-Oct-15,876406,1061446,733330,286667,40280,2998129
15-Oct-15,892993,1061840,746590,286667,40280,3028370
16-Oct-15,972431,1073057,762716,279992,39341,3127537
17-Oct-15,965876,1066907,755350,279992,39341,3107466
18-Oct-15,916625,1058157,726809,279992,39341,3020924
19-Oct-15,896002,1052446,750222,281325,39528,3019523
20-Oct-15,925725,1095050,755647,279491,39272,3095185
21-Oct-15,938261,1094484,750984,277066,38930,3099725
22-Oct-15,792541,1078822,718949,259895,36516,2886723
23-Oct-15,833812,984633,750029,246304,34606,2849384
24-Oct-15,809734,1056039,770338,248643,34931,2919685
25-Oct-15,779248,1052435,773383,259891,36518,2901475
26-Oct-15,866200,1025258,750140,270176,37962,2949736
27-Oct-15,858545,1049458,762929,277470,38987,2987389
28-Oct-15,784346,1043331,775538,272378,38271,2913864
29-Oct-15,815181,999267,753148,272158,38240,2877994
30-Oct-15,821102,966856,746886,273232,38389,2846465
31-Oct-15,808732,971137,715236,273035,38363,2806503
1-Nov-15,826688,989431,731368,259276,36429,2843192
2-Nov-15,862886,958838,704372,259565,36471,2822132
3-Nov-15,851147,1005437,709932,260293,36573,2863382
4-Nov-15,858532,1007450,723694,248621,34934,2873231
5-Nov-15,829533,1007450,737561,256245,36005,2866794
6-Nov-15,865435,994702,745834,256245,36005,2898221
7-Nov-15,789536,994702,760639,240174,33748,2818799
8-Nov-15,755355,1002930,729918,240174,33748,2762125
9-Nov-15,878525,987975,712513,258630,36339,2873982
10-Nov-15,882076,1021625,661586,258630,36339,2860256
11-Nov-15,832315,948673,622741,264804,37210,2705743
12-Nov-15,810205,869106,650115,264804,37210,2631440
13-Nov-15,839902,869106,684501,244909,34413,2672831
14-Nov-15,829695,910986,695693,244909,34413,2715696
15-Nov-15,816937,950301,688319,254299,35733,2745589
16-Nov-15,836073,950301,675021,254299,35733,2751427
17-Nov-15,797952,954721,673036,243979,34281,2703969
18-Nov-15,834502,983511,701509,243979,34281,2797782
19-Nov-15,794331,961256,709706,242031,34007,2741331
20-Nov-15,765142,962682,710676,242031,34007,2714538
21-Nov-15,797470,967390,694184,226091,31770,2716905
22-Nov-15,790789,963114,701880,234714,32979,2723476
23-Nov-15,782017,959186,691675,234714,32979,2700571
24-Nov-15,759533,980976,704621,234714,32979,2712823
25-Nov-15,824550,980299,711480,262360,36862,2815551
26-Nov-15,826539,977036,710844,262360,36862,2813641
27-Nov-15,842205,983535,705296,262360,36862,2830258
28-Nov-15,856187,969919,719447,261942,36803,2844298
29-Nov-15,809545,977816,702882,249724,35090,2775057
30-Nov-15,879336,944463,680678,262360,36862,2803699
1-Dec-15,764427,939248,674762,274845,38619,2691901
2-Dec-15,796239,935499,671203,274845,38619,2716405
3-Dec-15,763337,930433,651330,263772,37062,2645934
4-Dec-15,790572,916247,654565,263772,37062,2662218
5-Dec-15,788125,917588,666308,263772,37062,2672855
6-Dec-15,743180,925766,667980,254411,35745,2627082
7-Dec-15,831217,876430,677415,273359,38407,2696828
8-Dec-15,844630,936994,706047,273359,38407,2799437
9-Dec-15,863630,937023,718390,269035,37801,2825879
10-Dec-15,862065,940212,724762,262480,36882,2826401
11-Dec-15,831511,942787,730220,262480,36882,2803880
12-Dec-15,860105,935783,728021,262489,36883,2823281
13-Dec-15,818227,937515,724643,259049,36400,2775834
14-Dec-15,841862,896942,725635,263480,37021,2764940
15-Dec-15,832729,920232,738518,268618,37742,2797839
16-Dec-15,848999,932285,748754,268618,37742,2836398
17-Dec-15,816340,945661,743828,273597,38441,2817867
18-Dec-15,825546,952802,753716,273597,38441,2844102
19-Dec-15,861586,938563,751418,274075,38510,2864152
20-Dec-15,805948,916968,734196,264700,37193,2759005
21-Dec-15,857637,902470,732364,273736,38461,2804668
22-Dec-15,873337,936761,742425,256907,36097,2845527
23-Dec-15,840610,946619,764381,254335,35737,2841682
24-Dec-15,833730,931931,769688,254972,35826,2826147
25-Dec-15,876029,928665,759312,260871,36656,2861533
26-Dec-15,870621,891335,746348,260871,36656,2805831
27-Dec-15,819803,893670,730527,256538,36044,2736582
28-Dec-15,842316,896295,730224,260778,36641,2766254
29-Dec-15,852303,939789,743926,268062,37667,2841747
30-Dec-15,849999,933568,750383,268019,37659,2839628
31-Dec-15,840951,933568,724119,264265,37133,2800036
